等级配置表,,,,,,,
备注：,,,,,,,
ID,等级,金币,生命,魔法值,伤害,防御,体力
int,int,long,int,int,int,int,int
id,lv,gold,hp,mp,hurt,def,streng
1001,1,1000,1000,1000,10,1,1
1002,2,10,10,10,1,1,1
1003,3,10,10,10,1,1,1
1004,4,10,10,10,1,1,1
1005,5,50,50,50,5,5,5
1006,6,10,10,10,1,1,1
1007,7,10,10,10,1,1,1
1008,8,10,10,10,1,1,1
1009,9,10,10,10,1,1,1
1010,10,100,100,100,10,10,10
